* illa: isla
* intre: momento (en un punto preciso de tiempo)
* inverno: invierno
* inxección: inyección
* iogur: yogurt
* iota: letra j
* i grego: letra y
## L
* ladaíña: retahila
* laio: lamento
* lama: barro
* lamazal: lugar onde hai moita lama
* lámpada: lámpara
* lampexo: brillo, resplandor
* Lapis: lápiz
* lecer:
    1. Tempo dispoñible para facer algo ou para descansar. (Aproveita o lecer para facer deporte e estar en contacto coa natureza. )
    2. Estado anímico de quen goza de tranquilidade e sosego. (Desde que ti te fuches xa non tiven máis lecer.)
* lembrar: recordar, acordarse
* lei: ley
* leito: lecho (cama)
* levar: llevar
* Ligazón: link
* limpa: limpia
* Lingua: lengua
* lixo
    1. partícula pequena de sucidade
    2. conxunto de materias sucias ou de cousas que non serven o se tiran
* loita: lucha
* loura/louro:
    1. De cor castaña escura tirando a vermella, coma a da castaña madura.
    2. De cor castaña moi clara ou tirando á do ouro.
* louza: loza (barro)
* lúa: luna
## M
* mágoa: Lesión leve producida por un golpe, unha arma
* mais: pero
* máis: más
* maior: mayor
* man: mano
* mancadela: Lesión leve producida por un golpe, unha arma
* mañá: mañana
* marabilloso: maravilloso
* margarida: Planta herbácea da familia das compostas, que bota flores de
    pétalos brancos e centro amarelo e da que existen diversas especies.
* marxe: margen (do río)
* medo: miedo
* medrar: crecer
* meixela: mejilla
* mellores: mejores
* menciñeiro: curandero
* merlo: mirlo
* mesma/mesmo: misma/mismo
* mesturar: mezclar
* milagre: milagro
* mirouno de esguello: mirar de traves
* mofo: moho
* morea: montaña de cosas
* morrer: morir
* murmurio: murmullo
## N
* neboeira: néboa espexa e baixa
* neno: chico, niño
* ninguén: ningún
* niño: Construción de palla, barro ou outros materiais, que fan as aves para
    poñeren os ovos e criaren. Sinónimos aniñadoiro, niñeiro
* noiva: novia
* nós: nosotros
## O
* obriga: obligación
* obrigada: obligada
* ocasión: ocasión
* onda: Cada unha das elevacións producidas polo vento na superficie do mar, dun
    río ou dun lago.
* onde: No lugar en que.
* oseira: Lugar onde se depositan os ósos extraídos das sepulturas dos cemiterios.
* osíxeno: oxígeno
* ovais: ovalado
* ovo: huevo
* ouro: oro
* outra/outro: otra otro
## P
* Paisaxe: paisaje
* paixón: pasión
* pálpebra: párpado
* papaventos: cometa (juguete)
* Papeleira: papelera
* para (leído *pra*): para
* parolar: Falar moito e polo xeral de cousas sen importancia.
* Pechada: cerradas
* pecho (substantivo): cerrojo
* pecho (adxetivo)
1. Cousa que ten moi xuntos e en abundancia os elementos de que está composto
2. Moi apertado contra outro por ser abundante
3. Cuberto ou con abundancia daquilo que se expresa (amenceu pecho de neboeiro)
* peculio: diñeiro ou bens que posúe cada persoa
* pegada: pisada (pie)
* peitar: pagar como tributo o sobornar
* peite: peine
* peitear: peinar
* pelello: pellejo
* Pendente: pendiente
* pente: Peine
* perigo: peligro
* petar:
    1. dar golpes nunha cousa ou persona
    2. [Algo] apetecer a alguén
* petrucio: patrón
* Peza: pieza
* Pito: pollo
* po: polvo
* poboación: población
* póla: rama
* polo: pollo
* Portas: puertas
* pouta: pata
* Praia: playa
* pranto: llanto
* preto (advervio): cerca
* preto (adxetivo): apretado, tupido
* Primeiros: primeros
* Profundidade: profundidad
## Q
* quente: caliente
* quilómetros: kilómetros
## R
* rabuñar: arañar
* raiña: reina
* regra: regla
* rexeitar: rechazar, repeler
* Rochas: rocas
* roda: rueda
* Rolda: ronda
* ronsel
    1. Marca que deixa unha embarcación pola popa.
    2. Rastro que deixa alguén ou algo que pasa.
* roupa: ropa
## S
* sangue: sangre
* século: siglo
* segredo: secreto
* selar: sellar
* [selo](https://academia.gal/dicionario/-/termo/busca/selo): Pequena estampiña
    de papel que se cola nas cartas ou paquetes para pagar o seu transporte polo
    correo.
* semellar: asemejarse
* sinal: Cousa que é utilizada para indicar algo ou que por si soa indica algo.
* sinxela: sencilla
* só: sólo
* Soletrear: dicir unha por unha as letras de unha palabra.
* solpor: Hora en que o Sol se pon, e feito de ocultarse este no horizonte.
* sono: sueño
* sono: sueño
* Sueste: sudeste
* suor: sudor
* suxeito: estar sujeto
## T
* Táboa: tabla
* tamén: también
* Tarefa: tarea
* Tecidos: tejidos
* tella: teja
* tempada: temporada
* Tempo: tiempo
* tísica: tuberculosa
* toller (verbo)
    1. Deixar [alguén] con todos ou parte dos seus membros privados de movemento.
    2. Provocar un dano a [unha cousa, especialmente unha planta cultivada].
* toupa: topo
* Transcorre: transcurre
* troita: trucha
## U
* unlla: uña
* uña: uña
## V
* valado: vallado
* Vales: valles
* varrer: barrer
* vasoira: Instrumento formado por un pau ou mango que leva nun extremo
    un pequeno feixe de ramas ou doutro material flexible, que se emprega para
    varrer.
* vea: vena
* velaquí: Presenta algo o alguén que está á vista: "velaquí tes a roupa limpa"
    Úsase en ocasións para anunciar ou presentar un ou máis elementos posteriores no
    discurso: "velaquí a historia que queriades escoitar..."
* vella: Ser vivo que ten moita idade con respecto á duración normal da súa
    vida.
* verán: verano
* verme: gusano
* vernizar: barnizar
* viaxe: viaje
* voo: vuelo
* vós: vosotros
## X
* Xabón: jabón
* xamais: jamás
* xanela: ventanuco pequeño
* xeito:
  1. Cada unha das posibilidades diversas de facer unha cousa, de interpretala, de
     actuar, de ser.
  2. Forma máis conveniente ou idónea de facer algo.
* Xente: gente
* Xeral: general
* xogar: jugar
* xoia: joya
* xornal: periódico
## Z
* zume: zumo