## A
* abella: abeja
* abofé: con certeza
* abraiar: asombrar
* abraio: asombro
* abranguer: coller algo que apenas está ao alcance da man
* acadar: alcanzar
* aceno o xesto: gesto
* achegar: acercar
* acougar: calmar(se)
* acougo: Estado de quen está tranquilo física ou moralmente.
* adxetivo: adjetivo
* afastar: alejar
* afogar: ahogar
* agás (preposición): Excluíndo a persoa ou cousa que se expresa (Agás eu, todos
    saben algo de música.)
* agromar: brotar
* Aínda: 1. Indica que a acción ou o estado expresados polo verbo se seguen
    mantendo ou realizando no momento en que se fala ou do que se fala.
    Aínda está a durmir. Daquela aínda traballa, agora xa se retirou. Mañá aínda
    estás a tempo.
* aldraba: pestillo o llamador de puerta
* alporizar: producirlle ira o carraxe a alguén
* amencer: amanecer
* Amizade: amistad
* amolar: afilar
* anaco: trozo pequeño
* anguria: angustia
* Aniñar:
    1. agacharse para pór ou chocar os ovos, para protexer os pitos etc.
    2. Agacharse dobrando os xeonllos.
* Ano: año
* anoitecer: anochecer
* anoxar: aborrecer
* Antigos: antiguos
* antigüidade: antigüedad
* anxo: ángel
* apertar: apretar
* apócema: bebida medicinal
* apracible: apacible
* Árbore: árbol (xénero feminino)
* Areais: playa
* arrecendo, ou mellor, recendo (sustativo): xeiro bo
* Artigo: artículo
* ás: alas
* Asasinar: asesinar
* Auga: agua
* atallar: atajar
* Atrancos: atascos
* Avoa: abuela
* Avó: abuelo
* axiña: nun breve espazo de tempo (metendo prisa)
* Axuda: ayuda
## B
* badalada: campanada
* baeta: bayeta
* Baixa: baja
* baleirar: vaciar
* balor: moho
* bater: batir (alas, huevos...)
* bébedo: bebido
* beizo: labio
* bile: bilis
* bimbio: mimbre
* bisbarra: comarca
* bo: bueno
* bocoi: Recipiente de madeira destinado a conter líquidos, especialmente viño, máis grande ca o barril e ca a pipa, cunha capacidade media entre trescentos e setecentos litros.
* boneco, boneca: muñeco, muñeca
* Botar a culpa: echar la culpa
* Botar enriba: echarse encima
* branca: blanca
* branda: blanda
* brinde: brindis
* Burbullas: burbujas
## C
* cabuxo:
    1. cría da cabra
    2. enfado que dura pouco tempo
* cachiza: Parte pequena de algo que partiu ou rompeu.
* cachóns: Gran cantidade de burbullas que se forma na superficie da auga ao ferver ou ao caer, por exemplo, nunha fervenza.
* cadaleito: ataúd
* cadea: cadena
* cadeira: cadera o silla
* Caderno: cuaderno
* Cal: Cual
* caluga: nuca (cuello)
* campá: campana
* cárcere: cárcel
* carraxe: rabia
* carriza: musgo
* cativo (adxetivo): de mala calidad
* cativo (substantivo): niño
* Cedilla: letra cedilla
* cedo: temprano
* ceiba, ceibo (adxetivo): libre (adjetivo)
* ceibar:
    1. Deixar libre [algo ou a alguén que estaba suxeito, preso ou unido a algo].
    2. Lanzar [un obxecto] contra algo ou alguén.
* ceifa: siega
* ceifeiros: segadores
* chan (substantivo): suelo
* chan (adxetivo): plano
* chea: llena
* chiscar un ollo: guiñar un ojo
* Choiva: Lluvia
* chosca: que non ve dun ollo
* Cidade: ciudad
* cóbado: codo
* coma (conxunción): como
* Comunidade: comunidad
* Construción: construcción
* convidar: invitar
* conxuro: conjuro
* cor: color
* Cores: colores
* cousa: cosa
* Covas: cuevas
* Crueldade: crueldad
* curruncho: escondite
* cuspir: escupir
## D
* de cando en vez: de vez en cuando
* debruzado: apoyado
* debuxar: dibujar
* degoxo: desexo moi forte dunha cousa
* [deica](https://academia.gal/dicionario/-/termo/deica): Expresa o límite
    espacial ou temporal dunha acción a partir dun punto.
    *deica agora/logo*: Expresión de despedida que se emprega cando se espera
    volver ver o interlocutor nun curto espazo de tempo.
    Veño dentro dun pouco, deica agora.
    Marcho, Deica logo!
    *deica pouco*: Expresa que algo estivo a punto de ocorrer.
    Choveu tanto que deica pouco desborda o río.
    *deica un pouco*: Nun breve espazo de tempo.
    Marcho deica un pouco.
* dende: desde
* derradeira: última
* desarranxo: desorden
* desexo: deseo
* descrición: descripción
* dobre: doble
* doenza: dolencia
* dona: doña
* doutor: doctor
* durmir: dormir
## E
* e logo (e logo que fixo?): construcción de lenguaje para decir como, y entonces?
* eido: ámbito, campo
* encabuxar:
    1. Facer que [alguén] colla un cabuxo.
    2. [Persoa, en particular neno] sufrir un cabuxo ou enfado por non poder facer o que quere
* endexamais: nunca jamás
* enferruxar: oxidar
* engadir: añadir
* erro: error
* escachar:
    1. romper un obxecto fráxil en cachos
    2. [Auga] facer cachóns
    3. [Recipiente] conter un líquido que ferve a cachón.
* esconxuro: conjuro
* esculcar: observar atentamente
* esnaquizar: desfacer algo en anacos pequenos
* Espazo: espacio
* espertar: despertar
* Esquecer: olvidar
* estarrecer: aterrorizar
* esterco: estiércol
* esterqueira: estercolera
* estrada: carretera
## F
* falar: hablar
* feder: heder
* Feiras: ferias
* feitizo: hechizo
* Feminino: Femenino
* Ferida: Lesión nos tecidos dun ser vivo producida por unha causa exterior (un
    golpe, unha arma etc.), normalmente acompañada de sangue.
* ferruxo: óxido
* Fervenza: 1. Gran cantidade de burbullas que se forman ao precipitarse a auga
    dun río ou torrente por un desnivel brusco do terreo.
    2. Desnivel brusco ou pronunciado no leito dun río onde se precipita a auga.
* ficar: seguir no lugar ou na posición en que se está
* fío: hilo
* fiestra: ventana
* fochanca: socavón
* fociño: morrete
* folga
    1. Situación do que non realiza ningunha actividade ou do que descansa no
       traballo. (ocio, descanso)
    2. Interrupción voluntaria e colectiva do traballo, realizada como medida de presión para obter melloras laborais ou doutro tipo.
    3. Porción de tempo, xeralmente pequena. (anaco, momento) {Aínda tiven que
       esperar unha boa folga.}
* Folla: hoja
* frangulla o faragulla: migas
* froito: fruto
* fume: humo
* funil: embudo
* fuxir: huir
## G
* gabia: zanja
* garrida/garrido:
    1. Ben proporcionado, de boa presenza, agradable tanto pola aparencia física coma no trato.
    2. Pequeno regalo que se lles fai aos nenos
* gratitude: gratitud
* Grazas: Agradecimientos, gracias
* gromo: brote
* gue: letra g
## H
* horta: huerta
## I