User: 请介绍一些常用的性能监控工具和其使用方法，包括top、vmstat、sar等。
Assistant: 1. top

top是一款常用的Linux系统性能监控工具，可以实时监控CPU、内存和进程等信息。在终端中输入top命令即可打开，按下数字键1可以查看多核CPU的每个核的使用情况。

2. vmstat

vmstat是一种用于检查虚拟内存、进程、CPU和磁盘I/O的命令行工具。它可以提供实时的性能数据，包括CPU的使用情况、内存的使用情况、I/O负载等。

使用方法：
$ vmstat [选项]

选项：
-a : 等价与 -s、-m 和 -S all 。
-f : 显示fork、vfork和clone的数量。
-m : 显示内存使用情况和内存详细信息。
-n : 显示文件IO、块IO、中断和上下文切换的统计信息。
-p : 显示针对某个指定进程的统计信息。
-s : 显示操作系统统计信息。
-d : 显示磁盘统计信息。
-t : 显示CPU和进程信息。
-V : 显示版本信息。

3. sar

sar是一个用于系统性能监测和报告的工具，能够对CPU、内存、网络和磁盘I/O等资源进行监控。 它可以记录系统的性能数据，并将其转换为用户友好的格式，以便分析和调试。

使用方法：

$ sar [选项] [间隔时间] [次数]

选项：
-A : 显示所有指标的信息。
-b : 显示磁盘IO统计信息。
-c : 显示CPU的使用情况统计信息。
-d : 显示磁盘IO活动统计信息。
-g : 显示内存使用情况的统计信息。
-I : 显示中断统计信息。
-q : 显示队列长度和负载均衡情况。
-r : 显示内存和交换区的统计信息。
-u : 显示CPU使用率的统计信息。
-v : 显示进程、存储器、文件系统、网络等统计信息。