                       bundleDebugAndroidTestResources: task ':app:bundleDebugAndroidTestResources'
                       bundleDebugResources: task ':app:bundleDebugResources'
                       bundleDynamicProfileResources: task ':app:bundleDynamicProfileResources'
                       bundleDynamicReleaseResources: task ':app:bundleDynamicReleaseResources'
                       bundleProfileResources: task ':app:bundleProfileResources'
                       bundleReleaseResources: task ':app:bundleReleaseResources'
                       check: task ':app:check'
                       checkDebugManifest: task ':app:checkDebugManifest'
                       checkDynamicProfileManifest: task ':app:checkDynamicProfileManifest'
                       checkDynamicReleaseManifest: task ':app:checkDynamicReleaseManifest'
                       checkProfileManifest: task ':app:checkProfileManifest'
                       checkReleaseManifest: task ':app:checkReleaseManifest'
                       childProjects: {}
                       class: class org.gradle.api.internal.project.DefaultProject_Decorated
                       classLoaderScope: org.gradle.api.internal.initialization.DefaultClassLoaderScope@2075a565
                       cleanBuildCache: task ':app:cleanBuildCache'
                       compileDebugAidl: task ':app:compileDebugAidl'
                       compileDebugAndroidTestAidl: task ':app:compileDebugAndroidTestAidl'
                       compileDebugAndroidTestJavaWithJavac: task ':app:compileDebugAndroidTestJavaWithJavac'
                       compileDebugAndroidTestNdk: task ':app:compileDebugAndroidTestNdk'
                       compileDebugAndroidTestRenderscript: task ':app:compileDebugAndroidTestRenderscript'
                       compileDebugAndroidTestShaders: task ':app:compileDebugAndroidTestShaders'
                       compileDebugAndroidTestSources: task ':app:compileDebugAndroidTestSources'
                       compileDebugJavaWithJavac: task ':app:compileDebugJavaWithJavac'
                       compileDebugNdk: task ':app:compileDebugNdk'
                       compileDebugRenderscript: task ':app:compileDebugRenderscript'
                       compileDebugShaders: task ':app:compileDebugShaders'
                       compileDebugSources: task ':app:compileDebugSources'
                       compileDebugUnitTestJavaWithJavac: task ':app:compileDebugUnitTestJavaWithJavac'
                       compileDebugUnitTestSources: task ':app:compileDebugUnitTestSources'
                       compileDynamicProfileAidl: task ':app:compileDynamicProfileAidl'
                       compileDynamicProfileJavaWithJavac: task ':app:compileDynamicProfileJavaWithJavac'
                       compileDynamicProfileNdk: task ':app:compileDynamicProfileNdk'
                       compileDynamicProfileRenderscript: task ':app:compileDynamicProfileRenderscript'
                       compileDynamicProfileShaders: task ':app:compileDynamicProfileShaders'
                       compileDynamicProfileSources: task ':app:compileDynamicProfileSources'
                       compileDynamicProfileUnitTestJavaWithJavac: task ':app:compileDynamicProfileUnitTestJavaWithJavac'
                       compileDynamicProfileUnitTestSources: task ':app:compileDynamicProfileUnitTestSources'
                       compileDynamicReleaseAidl: task ':app:compileDynamicReleaseAidl'
                       compileDynamicReleaseJavaWithJavac: task ':app:compileDynamicReleaseJavaWithJavac'
                       compileDynamicReleaseNdk: task ':app:compileDynamicReleaseNdk'
                       compileDynamicReleaseRenderscript: task ':app:compileDynamicReleaseRenderscript'
                       compileDynamicReleaseShaders: task ':app:compileDynamicReleaseShaders'
                       compileDynamicReleaseSources: task ':app:compileDynamicReleaseSources'
                       compileDynamicReleaseUnitTestJavaWithJavac: task ':app:compileDynamicReleaseUnitTestJavaWithJavac'
                       compileDynamicReleaseUnitTestSources: task ':app:compileDynamicReleaseUnitTestSources'
                       compileLint: task ':app:compileLint'
                       compileProfileAidl: task ':app:compileProfileAidl'
                       compileProfileJavaWithJavac: task ':app:compileProfileJavaWithJavac'
                       compileProfileNdk: task ':app:compileProfileNdk'
                       compileProfileRenderscript: task ':app:compileProfileRenderscript'
                       compileProfileShaders: task ':app:compileProfileShaders'
                       compileProfileSources: task ':app:compileProfileSources'
                       compileProfileUnitTestJavaWithJavac: task ':app:compileProfileUnitTestJavaWithJavac'
                       compileProfileUnitTestSources: task ':app:compileProfileUnitTestSources'
                       compileReleaseAidl: task ':app:compileReleaseAidl'
                       compileReleaseJavaWithJavac: task ':app:compileReleaseJavaWithJavac'
                       compileReleaseNdk: task ':app:compileReleaseNdk'
                       compileReleaseRenderscript: task ':app:compileReleaseRenderscript'
                       compileReleaseShaders: task ':app:compileReleaseShaders'
                       compileReleaseSources: task ':app:compileReleaseSources'
                       compileReleaseUnitTestJavaWithJavac: task ':app:compileReleaseUnitTestJavaWithJavac'
                       compileReleaseUnitTestSources: task ':app:compileReleaseUnitTestSources'
                       components: SoftwareComponentInternal set
                       configurationActions: org.gradle.configuration.project.DefaultProjectConfigurationActionContainer@5d38042
                       configurationTargetIdentifier: org.gradle.configuration.ConfigurationTargetIdentifier$1@538e9205
                       configurations: configuration container
                       connectedAndroidTest: task ':app:connectedAndroidTest'
                       connectedCheck: task ':app:connectedCheck'
                       connectedDebugAndroidTest: task ':app:connectedDebugAndroidTest'
                       consumeConfigAttr: task ':app:consumeConfigAttr'
                       convention: org.gradle.api.internal.plugins.DefaultConvention@3716b47a
                       copyFlutterAssetsDebug: task ':app:copyFlutterAssetsDebug'
                       copyFlutterAssetsDynamicProfile: task ':app:copyFlutterAssetsDynamicProfile'
                       copyFlutterAssetsDynamicRelease: task ':app:copyFlutterAssetsDynamicRelease'
                       copyFlutterAssetsProfile: task ':app:copyFlutterAssetsProfile'
                       copyFlutterAssetsRelease: task ':app:copyFlutterAssetsRelease'
                       createDebugCompatibleScreenManifests: task ':app:createDebugCompatibleScreenManifests'
                       createDynamicProfileCompatibleScreenManifests: task ':app:createDynamicProfileCompatibleScreenManifests'
                       createDynamicReleaseCompatibleScreenManifests: task ':app:createDynamicReleaseCompatibleScreenManifests'
                       createProfileCompatibleScreenManifests: task ':app:createProfileCompatibleScreenManifests'
                       createReleaseCompatibleScreenManifests: task ':app:createReleaseCompatibleScreenManifests'
                       defaultArtifacts: org.gradle.api.internal.plugins.DefaultArtifactPublicationSet_Decorated@3a456170
                       defaultTasks: []
                       deferredProjectConfiguration: org.gradle.api.internal.project.DeferredProjectConfiguration@238d27ea
                       dependencies: org.gradle.api.internal.artifacts.dsl.dependencies.DefaultDependencyHandler_Decorated@4b48724
                       depth: 1
                       description: null
                       deviceAndroidTest: task ':app:deviceAndroidTest'
                       deviceCheck: task ':app:deviceCheck'
                       displayName: project ':app'
                       distsDir: /Volumes/Data/FlutterProjects/scanner/build/app/distributions
                       distsDirName: distributions
                       docsDir: /Volumes/Data/FlutterProjects/scanner/build/app/docs
                       docsDirName: docs
                       ext: org.gradle.api.internal.plugins.DefaultExtraPropertiesExtension@68356ac
                       extensions: org.gradle.api.internal.plugins.DefaultConvention@3716b47a
                       extractProguardFiles: task ':app:extractProguardFiles'
                       fileOperations: org.gradle.api.internal.file.DefaultFileOperations@17dce9ed
                       fileResolver: org.gradle.api.internal.file.BaseDirFileResolver@5d243e8b
                       flutter: FlutterExtension_Decorated@7d090fac
                       flutterBuildDebug: task ':app:flutterBuildDebug'
                       flutterBuildDynamicProfile: task ':app:flutterBuildDynamicProfile'
                       flutterBuildDynamicRelease: task ':app:flutterBuildDynamicRelease'
                       flutterBuildProfile: task ':app:flutterBuildProfile'
                       flutterBuildRelease: task ':app:flutterBuildRelease'
                       flutterBuildX86Jar: task ':app:flutterBuildX86Jar'
                       generateDebugAndroidTestAssets: task ':app:generateDebugAndroidTestAssets'
                       generateDebugAndroidTestBuildConfig: task ':app:generateDebugAndroidTestBuildConfig'
                       generateDebugAndroidTestResValues: task ':app:generateDebugAndroidTestResValues'
                       generateDebugAndroidTestResources: task ':app:generateDebugAndroidTestResources'
                       generateDebugAndroidTestSources: task ':app:generateDebugAndroidTestSources'
                       generateDebugAssets: task ':app:generateDebugAssets'
                       generateDebugBuildConfig: task ':app:generateDebugBuildConfig'
                       generateDebugResValues: task ':app:generateDebugResValues'
                       generateDebugResources: task ':app:generateDebugResources'
                       generateDebugSources: task ':app:generateDebugSources'
                       generateDynamicProfileAssets: task ':app:generateDynamicProfileAssets'
                       generateDynamicProfileBuildConfig: task ':app:generateDynamicProfileBuildConfig'
                       generateDynamicProfileResValues: task ':app:generateDynamicProfileResValues'
                       generateDynamicProfileResources: task ':app:generateDynamicProfileResources'
                       generateDynamicProfileSources: task ':app:generateDynamicProfileSources'
                       generateDynamicReleaseAssets: task ':app:generateDynamicReleaseAssets'
                       generateDynamicReleaseBuildConfig: task ':app:generateDynamicReleaseBuildConfig'
                       generateDynamicReleaseResValues: task ':app:generateDynamicReleaseResValues'
                       generateDynamicReleaseResources: task ':app:generateDynamicReleaseResources'
                       generateDynamicReleaseSources: task ':app:generateDynamicReleaseSources'
                       generateProfileAssets: task ':app:generateProfileAssets'
                       generateProfileBuildConfig: task ':app:generateProfileBuildConfig'
                       generateProfileResValues: task ':app:generateProfileResValues'
                       generateProfileResources: task ':app:generateProfileResources'
                       generateProfileSources: task ':app:generateProfileSources'
                       generateReleaseAssets: task ':app:generateReleaseAssets'
                       generateReleaseBuildConfig: task ':app:generateReleaseBuildConfig'
                       generateReleaseResValues: task ':app:generateReleaseResValues'
                       generateReleaseResources: task ':app:generateReleaseResources'
                       generateReleaseSources: task ':app:generateReleaseSources'
                       gradle: build 'android'
                       group: android
                       identityPath: :app
                       inheritedScope: org.gradle.api.internal.ExtensibleDynamicObject$InheritedDynamicObject@61a30097
                       installDebug: task ':app:installDebug'
                       installDebugAndroidTest: task ':app:installDebugAndroidTest'
                       installDynamicProfile: task ':app:installDynamicProfile'
                       installDynamicRelease: task ':app:installDynamicRelease'
                       installProfile: task ':app:installProfile'
                       installRelease: task ':app:installRelease'
                       javaPreCompileDebug: task ':app:javaPreCompileDebug'
                       javaPreCompileDebugAndroidTest: task ':app:javaPreCompileDebugAndroidTest'
                       javaPreCompileDebugUnitTest: task ':app:javaPreCompileDebugUnitTest'
                       javaPreCompileDynamicProfile: task ':app:javaPreCompileDynamicProfile'
                       javaPreCompileDynamicProfileUnitTest: task ':app:javaPreCompileDynamicProfileUnitTest'
                       javaPreCompileDynamicRelease: task ':app:javaPreCompileDynamicRelease'
                       javaPreCompileDynamicReleaseUnitTest: task ':app:javaPreCompileDynamicReleaseUnitTest'
                       javaPreCompileProfile: task ':app:javaPreCompileProfile'
                       javaPreCompileProfileUnitTest: task ':app:javaPreCompileProfileUnitTest'
                       javaPreCompileRelease: task ':app:javaPreCompileRelease'
                       javaPreCompileReleaseUnitTest: task ':app:javaPreCompileReleaseUnitTest'
                       layout: org.gradle.api.internal.file.DefaultProjectLayout@11400ecf
                       libsDir: /Volumes/Data/FlutterProjects/scanner/build/app/libs
                       libsDirName: libs
                       lint: task ':app:lint'
                       lintDebug: task ':app:lintDebug'
                       lintDynamicProfile: task ':app:lintDynamicProfile'