                       lintDynamicRelease: task ':app:lintDynamicRelease'
                       lintProfile: task ':app:lintProfile'
                       lintRelease: task ':app:lintRelease'
                       lintVitalRelease: task ':app:lintVitalRelease'
                       logger: org.gradle.internal.logging.slf4j.OutputEventListenerBackedLogger@68954260
                       logging: org.gradle.internal.logging.services.DefaultLoggingManager@6d6caa0a
                       mainApkListPersistenceDebug: task ':app:mainApkListPersistenceDebug'
                       mainApkListPersistenceDebugAndroidTest: task ':app:mainApkListPersistenceDebugAndroidTest'
                       mainApkListPersistenceDynamicProfile: task ':app:mainApkListPersistenceDynamicProfile'
                       mainApkListPersistenceDynamicRelease: task ':app:mainApkListPersistenceDynamicRelease'
                       mainApkListPersistenceProfile: task ':app:mainApkListPersistenceProfile'
                       mainApkListPersistenceRelease: task ':app:mainApkListPersistenceRelease'
                       mergeDebugAndroidTestAssets: task ':app:mergeDebugAndroidTestAssets'
                       mergeDebugAndroidTestJniLibFolders: task ':app:mergeDebugAndroidTestJniLibFolders'
                       mergeDebugAndroidTestResources: task ':app:mergeDebugAndroidTestResources'
                       mergeDebugAndroidTestShaders: task ':app:mergeDebugAndroidTestShaders'
                       mergeDebugAssets: task ':app:mergeDebugAssets'
                       mergeDebugJniLibFolders: task ':app:mergeDebugJniLibFolders'
                       mergeDebugResources: task ':app:mergeDebugResources'
                       mergeDebugShaders: task ':app:mergeDebugShaders'
                       mergeDynamicProfileAssets: task ':app:mergeDynamicProfileAssets'
                       mergeDynamicProfileJniLibFolders: task ':app:mergeDynamicProfileJniLibFolders'
                       mergeDynamicProfileResources: task ':app:mergeDynamicProfileResources'
                       mergeDynamicProfileShaders: task ':app:mergeDynamicProfileShaders'
                       mergeDynamicReleaseAssets: task ':app:mergeDynamicReleaseAssets'
                       mergeDynamicReleaseJniLibFolders: task ':app:mergeDynamicReleaseJniLibFolders'
                       mergeDynamicReleaseResources: task ':app:mergeDynamicReleaseResources'
                       mergeDynamicReleaseShaders: task ':app:mergeDynamicReleaseShaders'
                       mergeProfileAssets: task ':app:mergeProfileAssets'
                       mergeProfileJniLibFolders: task ':app:mergeProfileJniLibFolders'
                       mergeProfileResources: task ':app:mergeProfileResources'
                       mergeProfileShaders: task ':app:mergeProfileShaders'
                       mergeReleaseAssets: task ':app:mergeReleaseAssets'
                       mergeReleaseJniLibFolders: task ':app:mergeReleaseJniLibFolders'
                       mergeReleaseResources: task ':app:mergeReleaseResources'
                       mergeReleaseShaders: task ':app:mergeReleaseShaders'
                       mockableAndroidJar: task ':app:mockableAndroidJar'
                       modelRegistry: org.gradle.model.internal.registry.DefaultModelRegistry@582dbc64
                       modelSchemaStore: org.gradle.model.internal.manage.schema.extract.DefaultModelSchemaStore@72034d1
                       module: org.gradle.api.internal.artifacts.ProjectBackedModule@55dbf325
                       name: app
                       normalization: org.gradle.normalization.internal.DefaultInputNormalizationHandler_Decorated@2173a84e
                       objects: org.gradle.api.internal.model.DefaultObjectFactory@30d4fcd9
                       org.gradle.jvmargs: -Xmx1536M
                       packageDebug: task ':app:packageDebug'
                       packageDebugAndroidTest: task ':app:packageDebugAndroidTest'
                       packageDynamicProfile: task ':app:packageDynamicProfile'
                       packageDynamicRelease: task ':app:packageDynamicRelease'
                       packageProfile: task ':app:packageProfile'
                       packageRelease: task ':app:packageRelease'
                       parent: root project 'android'
                       parentIdentifier: root project 'android'
                       path: :app
                       platformAttrExtractor: task ':app:platformAttrExtractor'
                       pluginManager: org.gradle.api.internal.plugins.DefaultPluginManager_Decorated@38e03c33
                       plugins: [org.gradle.api.plugins.HelpTasksPlugin@2e458787, com.android.build.gradle.api.AndroidBasePlugin@415b1e45, org.gradle.language.base.plugins.LifecycleBasePlugin@661f154a, org.gradle.api.plugins.BasePlugin@72927c9d, org.gradle.api.plugins.ReportingBasePlugin@5855d0a5, org.gradle.platform.base.plugins.ComponentBasePlugin@4289fc5f, org.gradle.language.base.plugins.LanguageBasePlugin@342fcc53, org.gradle.platform.base.plugins.BinaryBasePlugin@2618f46f, org.gradle.api.plugins.JavaBasePlugin@60215f4c, com.android.build.gradle.AppPlugin@1357dda5, FlutterPlugin@16da962c, com.google.gms.googleservices.GoogleServicesPlugin@21b34504]
                       preBuild: task ':app:preBuild'
                       preDebugAndroidTestBuild: task ':app:preDebugAndroidTestBuild'
                       preDebugBuild: task ':app:preDebugBuild'
                       preDebugUnitTestBuild: task ':app:preDebugUnitTestBuild'
                       preDynamicProfileBuild: task ':app:preDynamicProfileBuild'
                       preDynamicProfileUnitTestBuild: task ':app:preDynamicProfileUnitTestBuild'
                       preDynamicReleaseBuild: task ':app:preDynamicReleaseBuild'
                       preDynamicReleaseUnitTestBuild: task ':app:preDynamicReleaseUnitTestBuild'
                       preProfileBuild: task ':app:preProfileBuild'
                       preProfileUnitTestBuild: task ':app:preProfileUnitTestBuild'
                       preReleaseBuild: task ':app:preReleaseBuild'
                       preReleaseUnitTestBuild: task ':app:preReleaseUnitTestBuild'
                       prepareLintJar: task ':app:prepareLintJar'
                       preparePUBLISHED_DEXDebugAndroidTestForPublishing: task ':app:preparePUBLISHED_DEXDebugAndroidTestForPublishing'
                       preparePUBLISHED_DEXDebugForPublishing: task ':app:preparePUBLISHED_DEXDebugForPublishing'
                       preparePUBLISHED_DEXDynamicProfileForPublishing: task ':app:preparePUBLISHED_DEXDynamicProfileForPublishing'
                       preparePUBLISHED_DEXDynamicReleaseForPublishing: task ':app:preparePUBLISHED_DEXDynamicReleaseForPublishing'
                       preparePUBLISHED_DEXProfileForPublishing: task ':app:preparePUBLISHED_DEXProfileForPublishing'
                       preparePUBLISHED_DEXReleaseForPublishing: task ':app:preparePUBLISHED_DEXReleaseForPublishing'
                       preparePUBLISHED_JAVA_RESDebugAndroidTestForPublishing: task ':app:preparePUBLISHED_JAVA_RESDebugAndroidTestForPublishing'
                       preparePUBLISHED_JAVA_RESDebugForPublishing: task ':app:preparePUBLISHED_JAVA_RESDebugForPublishing'
                       preparePUBLISHED_JAVA_RESDynamicProfileForPublishing: task ':app:preparePUBLISHED_JAVA_RESDynamicProfileForPublishing'
                       preparePUBLISHED_JAVA_RESDynamicReleaseForPublishing: task ':app:preparePUBLISHED_JAVA_RESDynamicReleaseForPublishing'
                       preparePUBLISHED_JAVA_RESProfileForPublishing: task ':app:preparePUBLISHED_JAVA_RESProfileForPublishing'
                       preparePUBLISHED_JAVA_RESReleaseForPublishing: task ':app:preparePUBLISHED_JAVA_RESReleaseForPublishing'
                       preparePUBLISHED_NATIVE_LIBSDebugAndroidTestForPublishing: task ':app:preparePUBLISHED_NATIVE_LIBSDebugAndroidTestForPublishing'
                       preparePUBLISHED_NATIVE_LIBSDebugForPublishing: task ':app:preparePUBLISHED_NATIVE_LIBSDebugForPublishing'
                       preparePUBLISHED_NATIVE_LIBSDynamicProfileForPublishing: task ':app:preparePUBLISHED_NATIVE_LIBSDynamicProfileForPublishing'
                       preparePUBLISHED_NATIVE_LIBSDynamicReleaseForPublishing: task ':app:preparePUBLISHED_NATIVE_LIBSDynamicReleaseForPublishing'
                       preparePUBLISHED_NATIVE_LIBSProfileForPublishing: task ':app:preparePUBLISHED_NATIVE_LIBSProfileForPublishing'
                       preparePUBLISHED_NATIVE_LIBSReleaseForPublishing: task ':app:preparePUBLISHED_NATIVE_LIBSReleaseForPublishing'
                       processDebugAndroidTestJavaRes: task ':app:processDebugAndroidTestJavaRes'
                       processDebugAndroidTestManifest: task ':app:processDebugAndroidTestManifest'
                       processDebugAndroidTestResources: task ':app:processDebugAndroidTestResources'
                       processDebugGoogleServices: task ':app:processDebugGoogleServices'
                       processDebugJavaRes: task ':app:processDebugJavaRes'
                       processDebugManifest: task ':app:processDebugManifest'
                       processDebugResources: task ':app:processDebugResources'
                       processDebugUnitTestJavaRes: task ':app:processDebugUnitTestJavaRes'
                       processDynamicProfileGoogleServices: task ':app:processDynamicProfileGoogleServices'
                       processDynamicProfileJavaRes: task ':app:processDynamicProfileJavaRes'
                       processDynamicProfileManifest: task ':app:processDynamicProfileManifest'
                       processDynamicProfileResources: task ':app:processDynamicProfileResources'
                       processDynamicProfileUnitTestJavaRes: task ':app:processDynamicProfileUnitTestJavaRes'
                       processDynamicReleaseGoogleServices: task ':app:processDynamicReleaseGoogleServices'
                       processDynamicReleaseJavaRes: task ':app:processDynamicReleaseJavaRes'
                       processDynamicReleaseManifest: task ':app:processDynamicReleaseManifest'
                       processDynamicReleaseResources: task ':app:processDynamicReleaseResources'
                       processDynamicReleaseUnitTestJavaRes: task ':app:processDynamicReleaseUnitTestJavaRes'
                       processOperations: org.gradle.api.internal.file.DefaultFileOperations@17dce9ed
                       processProfileGoogleServices: task ':app:processProfileGoogleServices'
                       processProfileJavaRes: task ':app:processProfileJavaRes'
                       processProfileManifest: task ':app:processProfileManifest'
                       processProfileResources: task ':app:processProfileResources'
                       processProfileUnitTestJavaRes: task ':app:processProfileUnitTestJavaRes'
                       processReleaseGoogleServices: task ':app:processReleaseGoogleServices'
                       processReleaseJavaRes: task ':app:processReleaseJavaRes'
                       processReleaseManifest: task ':app:processReleaseManifest'
                       processReleaseResources: task ':app:processReleaseResources'
                       processReleaseUnitTestJavaRes: task ':app:processReleaseUnitTestJavaRes'
                       project: project ':app'
                       projectConfigurator: org.gradle.api.internal.project.BuildOperationCrossProjectConfigurator@d1b69d7
                       projectDir: /Volumes/Data/FlutterProjects/scanner/android/app
                       projectEvaluationBroadcaster: ProjectEvaluationListener broadcast
                       projectEvaluator: org.gradle.configuration.project.LifecycleProjectEvaluator@311681e2
                       projectPath: :app
                       projectRegistry: org.gradle.api.internal.project.DefaultProjectRegistry@26b3812d
                       properties: {...}
                       providers: org.gradle.api.internal.provider.DefaultProviderFactory@75720115
                       reportBuildArtifactsDebug: task ':app:reportBuildArtifactsDebug'
                       reportBuildArtifactsDynamicProfile: task ':app:reportBuildArtifactsDynamicProfile'
                       reportBuildArtifactsDynamicRelease: task ':app:reportBuildArtifactsDynamicRelease'
                       reportBuildArtifactsProfile: task ':app:reportBuildArtifactsProfile'
                       reportBuildArtifactsRelease: task ':app:reportBuildArtifactsRelease'
                       reporting: org.gradle.api.reporting.ReportingExtension_Decorated@1f8b306c
                       reportsDir: /Volumes/Data/FlutterProjects/scanner/build/app/reports
                       repositories: repository container
                       resolveConfigAttr: task ':app:resolveConfigAttr'
                       resourceLoader: org.gradle.internal.resource.transfer.DefaultUriTextResourceLoader@4908a79b
                       resources: org.gradle.api.internal.resources.DefaultResourceHandler@4c9426c9
                       rootDir: /Volumes/Data/FlutterProjects/scanner/android
                       rootProject: root project 'android'
                       script: false
                       scriptHandlerFactory: org.gradle.api.internal.initialization.DefaultScriptHandlerFactory@76146c9f
                       scriptPluginFactory: org.gradle.configuration.ScriptPluginFactorySelector@30da2a61
                       serviceRegistryFactory: org.gradle.internal.service.scopes.ProjectScopeServices$4@3ce2679e
                       services: ProjectScopeServices
                       signingReport: task ':app:signingReport'
                       sourceCompatibility: 1.8
                       sourceSets: SourceSet container
                       splitsDiscoveryTaskDebug: task ':app:splitsDiscoveryTaskDebug'
                       splitsDiscoveryTaskDynamicProfile: task ':app:splitsDiscoveryTaskDynamicProfile'
                       splitsDiscoveryTaskDynamicRelease: task ':app:splitsDiscoveryTaskDynamicRelease'
                       splitsDiscoveryTaskProfile: task ':app:splitsDiscoveryTaskProfile'
                       splitsDiscoveryTaskRelease: task ':app:splitsDiscoveryTaskRelease'
                       standardOutputCapture: org.gradle.internal.logging.services.DefaultLoggingManager@6d6caa0a
                       state: project state 'EXECUTED'
                       status: integration
                       subprojects: []
                       targetCompatibility: 1.8
                       tasks: task set
                       test: task ':app:test'
                       testDebugUnitTest: task ':app:testDebugUnitTest'
                       testDynamicProfileUnitTest: task ':app:testDynamicProfileUnitTest'
                       testDynamicReleaseUnitTest: task ':app:testDynamicReleaseUnitTest'
                       testProfileUnitTest: task ':app:testProfileUnitTest'
                       testReleaseUnitTest: task ':app:testReleaseUnitTest'
                       testReportDir: /Volumes/Data/FlutterProjects/scanner/build/app/reports/tests